12 10
.####.....
##..###...
#@A...#...
###.A.#...
.#..######
.#..Aaaaa#
.#..#.####
.##.#.#...
.#.A#.#...
.#....#...
.#..###...
.####.....