7 15
###########....
#..a..#...#....
#.#a..@...#....
#..#aa#.#######
##..##.AA.A.A.#
.##...........#
..#############