10 12
...####.....
...#..#.....
.###..#.....
##..A.#.....
#...#.#.....
#.#AA.######
#.#...#...a#
#..A..@...a#
###..####aa#
..####..####