8 13
......#####..
......#...##.
......#.A..#.
########.#@##
#.a..#.A.A..#
#........A#.#
#aaa#####...#
#####...#####