9 8
..####..
..#..#..
..#@.#..
..#..#..
###.####
#....1.#
#..A...#
#####a.#
....####