10 8
#####...
#.@.####
#......#
#.A.AA.#
##A##..#
#...####
#.aa..#.
##aa..#.
.###..#.
...####.