8 10
########..
#.@.#..#..
#......#..
#####A.#..
....#..###
.##.#A.aa#
.##.#..###
....####..