11 11
.#########.
##...#...##
#....#....#
#..A.#.A..#
#...1a1...#
####a@a####
#...1a1...#
#..A.#.A..#
#....#....#
##...#...##
.#########.