10 22
...............#####..
...............#...#..
#######..#######.#.#..
#.....#..#..#......#..
#..@..####..#.....####
#..#....aaaa##.####..#
#....#####.##.AA.A.A.#
######...#...........#
.........#..##########
.........####.........