8 7
#######
#.....#
#.aAa.#
#.AaA.#
#.aAa.#
#.AaA.#
#..@..#
#######