8 11
......#####
......#a..#
......#a#.#
#######a#.#
#.@.A.A.A.#
#.#.#.#.###
#.......#..
#########..