6 7
#######
#.....#
#.#.#.#
#a.A1@#
#...###
#####..