10 9
.....####
######..#
#.......#
#..aaa.a#
##A######
#.A..#...
#...A###.
##..A..#.
.##.@..#.
..######.