7 7
.#####.
##a.a##
#.1.1.#
#..#..#
#.A.A.#
##.@.##
.#####.