7 12
.###########
##aaaaaaa..#
#.AAAAAAA@.#
#...#.#.#.##
#.#.#.....#.
#...#######.
#####.......