9 13
###########..
#.....#...###
#.A@A.#.a..a#
#.##.###.##.#
#.#.......#.#
#.#...#...#.#
#.#########.#
#...........#
#############