9 9
....#####
#####...#
#....A..#
#..A#A#@#
###.#...#
..#.aaa.#
..###..##
....#..#.
....####.