8 10
.####.....
.#..####..
.#.....##.
##.##...#.
#a.a#.@A##
#...#.AA.#
#..a#....#
##########