12 12
...####.....
.###..#####.
.#.AA.#...#.
.#.A.a.aAA##
.#.aa.#a.A.#
###.#11.a..#
#..a.11#.###
#.A.a#.aa.#.
##AAa@a.A.#.
.#...#.AA.#.
.#####..###.
.....####...