9 9
.#######.
##..a..##
#.aAAAa.#
#.Aa.aA.#
#aA.@.Aa#
#.Aa.aA.#
#.aAAAa.#
##..a..##
.#######.