7 10
##########
#........#
#.##a###.#
#.#.AA.a.#
#.a.@A##.#
#####....#
....######