9 9
..####...
..#..#...
..#..####
###AaA..#
#..a@a..#
#..AaA###
####..#..
...#..#..
...####..