11 11
.######....
.#.a..#....
##Aa#.#....
#..1..#....
#.aa###....
##A.#.#####
##.##.#...#
#..####.#.#
#...@.A.A.#
##..#.....#
.##########