8 9
....####.
..###..##
.##.A...#
##.A..#.#
#.@#AA..#
#.aa..###
#.aa###..
#####....