11 11
...#####...
...#.@.#...
..##...##..
###aAAAa###
#..AaaaA..#
#..Aa#aA..#
#..AaaaA..#
###aAAAa###
..##...##..
...#...#...
...#####...