8 8
########
#@.....#
#.aAAa.#
#.AaaA.#
#.AaaA.#
#.aAAa.#
#......#
########