8 9
#########
#.@.#...#
#.A.A...#
##A###.##
#..aaa..#
#...#...#
######..#
.....####