6 8
########
#......#
#.a11A@#
#......#
#####..#
....####