8 8
#####...
#...###.
#.a...##
##1#A..#
#.a#.A.#
#.@##.##
#.....#.
#######.