10 8
######..
#....##.
#.A.A.##
##.AA..#
.#.#...#
.#.##.##
.#..a.a#
.#.@a.a#
.#..####
.####...