11 11
......####.
#######..#.
#.A......##
#.A#####..#
#..@#..#..#
##.##aa...#
#..#.aa####
#.A..###...
#.A###.....
#..#.......
####.......