6 9
..####...
###..####
#.....A.#
#.#..#A.#
#.a.a#@.#
#########