8 9
..######.
..#....#.
..#.##@##
###.#.A.#
#.aa#.A.#
#.......#
#..######
####.....