5 11
###########
#....a##..#
#.AA@aaAA.#
#...##a...#
###########