8 10
.#######..
.#..a.a###
.#.a.a.a.#
###.####.#
#..@A..A.#
#..AA..A.#
####...###
...#####..