8 6
..####
###.@#
#..A.#
#..1a#
#..1a#
#..A.#
###..#
..####