7 11
#######....
#.....#####
#.AA#@##aa#
#.#.......#
#..A.#.#..#
####.A..aa#
...########