10 10
.#####....
##...##...
#..A..##..
#.A.A..##.
###A#.a.##
..#.#.a..#
.##.##a..#
.#.@..a.##
.#...#..#.
.########.