9 14
##############
#......#.....#
#.A@AA.#.a.aa#
##.##.###.##.#
.#.#.......#.#
.#.#...#...#.#
.#.#########.#
.#...........#
.#############