13 14
...#####......
..##...#......
###..#.#......
#....a.#......
#..##.#####...
#..a.a.#..##..
#..#.@.A...###
#####a.#..A..#
....####..A..#
.......##.A.##
........#..##.
........#..#..
........####..