7 8
####....
#..###..
#....###
#..A1@.#
###.a#.#
..#....#
..######