11 15
########.......
#......#.......
#.A.AA.########
#####.@##a.a..#
....#A..#.a...#
....#...#a.a.##
....#A#.##.#.#.
....#........#.
....#..###..##.
....#..#.####..
....####.......