9 9
..####...
..#..#...
..#.A####
###a.a..#
#.A.#.A.#
#..a.a###
####A.#..
...#.@#..
...####..