13 10
.#####....
##...####.
#..AAA..#.
#.#...A.#.
#...A##.##
###..#a..#
..#..#...#
.#####.###
.#...#.##.
.#.@aaaa#.
.#......#.
.#...#..#.
.########.