15 9
####.....
#..####..
#.A...#..
#.a#..#..
#.A#.##..
#.a..#...
####.#...
...#.#...
.###.###.
.#..A..#.
##.#A#.##
#.A.@.A.#
#.aa#aa.#
###...###
..#####..