8 12
......######
......#....#
..#####.a..#
###..###a..#
#.A..A..a.##
#.@AA.#.a.#.
##....#####.
.######.....