10 13
.......####..
......##..###
####..#..A..#
#..####.A.A.#
#...aa#.#A..#
#..#...@..###
##.#aa#.###..
.#.##.#.#....
.#......#....
.########....