8 9
.#######.
.#.....#.
##.###A##
#aA...@.#
#.aa.#A.#
#a##..A.#
#....####
######...