10 9
..######.
..#....##
.##.##..#
.#.AA.#.#
.#.@A.#.#
.#....#.#
####.#..#
#..aaa.##
#.....##.
#######..