9 10
##.####...
####..####
.#.A.Aa..#
##.#..aA.#
#...##a###
#..A..a.#.
#.@.#...#.
#..######.
####......