7 10
.####.....
.#..######
##....A..#
#.a#.A...#
#.a#A#####
#.a@.#....
######....