10 9
########.
#......#.
#.####.#.
#.#aaa@#.
#.###A###
#.#.....#
#..AA.A.#
####...##
...#a###.
...###...