10 14
...####.......
...#..########
####.A.Aaaaaa#
#...A...######
#@###.###.....
#..A..#.......
#.A.#.#.......
##.#..#.......
.#....#.......
.######.......