9 10
.########.
.#......#.
.#@...A.#.
##.###A.#.
#.aaaaa###
#.A.A.A..#
######.#.#
.....#...#
.....#####