7 10
.#######..
##.aaaa##.
#...######
#...A.A.@#
###..A.A.#
..###....#
....######