8 15
####.....#####.
#..###...#...##
#....#...#A.A.#
#aa#.#####.#..#
#..@....#.A.A.#
#aa#.........##
##...#########.
.#####.........