11 10
####......
#..#######
#..a.##.a#
#.A#....a#
##.##.#.a#
.#....#..#
.####.#..#
..#.@A.###
..#.AA.#..
..#....#..
..######..