9 9
..######.
..#....#.
..#..A.#.
.####A.#.
##.A.A.#.
#aaaa#.##
#.....@.#
##..#...#
.########