7 10
.########.
.#..@...#.
.#.A..A.#.
###.##.###
#..AaaA..#
#...aa...#
##########