10 12
.......#####
########...#
#a...a..@#a#
#..###.....#
##.A..#....#
.#.A...#####
.#.A#..#....
.##.#..#....
..#...##....
..#####.....