9 15
######.####....
#.....#....#...
#a##..#A##..#..
#...#.....#..#.
#A..#.###..#..#
#.#......#..#.#
#.#.####..#.#.#
#a.@....A.1.a.#
###############