5 7
#######
#.....#
#.@Aa.#
#.....#
#######

