5 7
#######
#.....#
#.A...#
#.....#
#####@#
