5 8
########
#..a...#
#...@Aa#
#......#
########