5 6
######
#..@.#
#..A.#
#....#
######
