5 8
########
#......#
#..AA@.#
#......#
########
