9 10
#####.....
#...####..
#.#.#.a#..
#....A.###
###.#Aa..#
#...#@...#
#.#.######
#...#.....
#####.....