8 7
.######
##....#
#..##.#
#.#.A.#
#..1.a#
##.#@##
.#...#.
.#####.