8 8
#######.
#.@#..#.
#aA...#.
#a.#.A##
#aA#...#
#a.#.A.#
#..#...#
########