10 15
..####.........
..#..#....#####
..#..#....#...#
..#..######a#.#
####..A....a..#
#...AA#.###a#.#
#...#...#.#...#
#########.#@.##
..........#..#.
..........####.