11 11
..######...
..#....#...
..#....#...
#####..#...
#...#a#####
#...A@A...#
#####a#...#
...##.##.##
...#...Aa#.
...#...###.
...#####...