10 16
#####...........
#...##.####.....
#..A.###.a#.....
#.A...A..a#.....
##.A#####a#.####
#.A..#.#.a###..#
#....#.#.a#..@.#
###..#.#.......#
..####.##.....##
........#######.