13 9
..#######
#.#.....#
#.#.#.#.#
..#.@.A.#
###.###.#
#...###.#
#.A..##a#
##.A..#a#
.##.A..a#
#.##.A#a#
##.##.#a#
###.#...#
###.#####