9 10
..########
..#..#.a.#
..#...a1a#
..#..#.1.#
####A##a##
#......A.#
#.A.##.A.#
#...@#...#
##########