6 10
.#########
.#....#..#
##.A#A#..#
#..aAa@..#
#..a#....#
##########