8 8
######..
#..@.#..
#..#.##.
#.a#..##
#.aAAA.#
#.a#...#
####...#
...#####