12 16
.####...........
##..####........
#...aaa#........
#...aaa#........
#...#.##........
#...#@.####.####
#####.A...###..#
....#..##A.A...#
...###.....AA..#
...#.A..##...###
...#....######..
...######.......