8 9
#######..
#.....###
#..@AAaa#
####.##.#
..#.....#
..#..####
..#..#...
..####...