8 11
.####......
.#..#######
.#A.@#...a#
##.#AA...a#
#..A..##aa#
#...#.#####
###...#....
..#####....