9 11
.....#####.
.....#...##
.....#....#
.######...#
##.....#a.#
#.A.A.@..##
#.######a#.
#........#.
##########.