9 10
##########
#...##...#
#.A..A@#.#
####.#.A.#
...#a#..##
.#.#a#.A#.
.#.#a...#.
.#.#a...#.
...######.