8 8
..#####.
..#.a.##
###.A..#
#.a.A#@#
#.#A.a.#
#..A.###
##.a.#..
.#####..