7 11
..#######..
###.....#..
#.A.A...#..
#.###.#####
#.@.a.a...#
#...###...#
#####.#####