7 8
.#######
.#.....#
.#.aAa.#
##.A@A.#
#..aAa.#
#......#
########