9 11
######.....
#....###...
#..#.A.#...
#..A.@.#...
##.##.#####
#..#aaaaaa#
#.A.A.A.A.#
##...######
.#####.....