6 13
...##########
####....##..#
#..AAAaaaaA@#
#......###..#
#...####.####
#####........