7 9
.....###.
######@##
#....a1.#
#...#...#
#####A#.#
....#...#
....#####