7 10
.....#####
...###...#
####aaaaa#
#.@AAAAA.#
#.....#.##
#####...#.
....#####.