6 8
#######.
#.....#.
#@AAA.##
#..#aaa#
##....##
.######.