8 11
..#########
###.@.#...#
#.1.A.1aa.#
#...A.#...#
####1#..###
.#.....##..
.#...###...
.#####.....