8 9
......###
#####.#a#
#...###a#
#...A.#a#
#.A..A..#
#####@#.#
....#...#
....#####