11 10
.#####....
##...#....
#....#####
#..#a#...#
#@.#a#.A.#
#..#a#..##
#....#..#.
##..##AA#.
.##.....#.
..#..####.
..####....