8 11
..#########
###...#...#
#.1.A.a.a.#
#...A.##.##
####1#...#.
.#..@..###.
.#...###...
.#####.....