9 10
.######...
##....#...
#...A.#...
#..AA.#...
###.a#####
..##a#.@.#
...#a..A.#
...#a.####
...####...