8 8
########
#...aa.#
#..@AA.#
#####.##
...#..#.
...#..#.
...#..#.
...####.