9 14
########.#####
#..#...###...#
#......##.A..#
#a#.@.##.A..##
#a#...#.A..##.
#a#....A..##..
#a.##.#####...
##....#.......
.######.......