7 6
######
#aaa.#
#..A.#
#.#A##
#..A.#
#..@.#
######