11 10
..####....
.##..#####
.#..A..@.#
.#..A#...#
####.#####
#..#...#..
#....A.#..
#.aa#..#..
#..a####..
#..##.....
####......