8 8
########
#......#
#.A111.#
#.1..1.#
#.1..1.#
#.111a.#
#.....@#
########