10 12
........####
#########..#
#...##.A...#
#..A...##..#
###.#a.a#.##
..#.#a.a#A##
..#.#...#..#
..#.@.A....#
..#..#######
..####......