12 11
#####......
#...###....
#.#A..#....
#.A...#....
#.A.A.#....
#.A#..#....
#..@###....
##.########
#......aaa#
#.........#
########aa#
.......####