11 12
..####......
###..#......
#....###....
#.#.a.a#....
#.@.aaa####.
#.#.#.#...##
#...#.AA...#
#####..A.A.#
....##A.#.##
.....#....#.
.....######.