6 9
..####...
###..####
#.......#
#@A111a.#
#.......#
#########