8 10
####......
#.@###....
#a1..#####
#aa#AA.A.#
##.......#
.#.#.##..#
.#...#####
.#####....