12 9
######...
#....####
#....aaa#
#....aaa#
######..#
..#..#..#
..#.AA.##
..#.@A..#
..#.AA..#
..##.A#.#
...#....#
...######