7 7
#######
#a.#..#
#..A..#
#a.A#@#
#..A..#
#a.#..#
#######