9 13
############.
#..........#.
#.#######.@##
#.#.........#
#.#..A...#..#
#.AA.#####..#
###..#.#.aaa#
..####.#....#
.......######