10 11
.####.####.
.#..###..##
.#......@.#
##aa###...#
#......#..#
#aaa#A..#.#
#.##.AA.A.#
#..A....###
####..###..
...####....