9 9
.....####
.....#.@#
.....#..#
######.a#
#...A..a#
#..AA#.a#
#....####
###..#...
..####...