10 12
########....
#..aaa.#....
#..###.##...
#..#.A..#...
##.#@A..#...
.#.#.A..#...
.#.###.#####
.#.........#
.#...###...#
.#####.#####