11 11
.####.####.
##..###..##
#...#.#...#
#..1a.a1..#
###A...A###
.#...@...#.
###A...A###
#..1a.a1..#
#...#.#...#
##..###..##
.####.####.