8 11
####..####.
#..####..#.
#..#..#..#.
#..#....A##
#..a.a#A..#
#@.##.#.A.#
#...a.#...#
###########