10 8
######..
#.@..#..
#.A#.#..
#.A..#..
#.A.##..
###.####
.#..#..#
.#aaa..#
.#.....#
.#######