10 10
.#########
.#.......#
##@#####.#
#..#...#.#
#..#...Aa#
#..##A##a#
##A##..#a#
#...A..#a#
#...#..###
########..