11 11
.......####
.#######..#
.#.A......#
.#...A.A..#
.#.########
##.#.a..#..
#..#.#..#..
#..@.a.##..
##.#.#.#...
.#...a.#...
.#######...