7 7
#.#####
..#...#
###AA@#
#...###
#.....#
#.a.a.#
#######