7 12
#####..#####
#...####aa.#
#.AAA......#
#...A#..aa.#
###.@#..##.#
..#..##....#
..##########