7 10
..####....
###..#####
#..A..@aa#
#.A....#.#
###.####.#
..#......#
..########