12 8
..######
..#.aa@#
..#.AA.#
..##.###
...#.#..
...#.#..
####.#..
#....##.
#.#...#.
#...#.#.
###...#.
..#####.