8 12
....#####...
#####...####
#.....#....#
#..#aaaaa..#
##..##.#.###
.#AA@AAA.#..
.#.....###..
.#######....