6 12
######.#####
#....###...#
#.AA.....#@#
#.A.#aaa...#
#...########
#####.......