8 11
###########
#aaaa#....#
#..#...AA.#
#..@..##..#
#.....##A.#
######..A.#
.....#....#
.....######