10 8
####....
#..#####
#.AA.A.#
#......#
##.##.##
#aaa#@#.
#.###.##
#......#
#..#...#
########