14 9
...###...
...#@#...
.###A###.
##..a..##
#..#.#..#
#.#...#.#
#.#...#.#
#.#...#.#
#..#.#..#
##.A.A.##
.##a.a##.
..#...#..
..#...#..
..#####..