7 11
##########.
#.@.aaaa.#.
#...####A##
##.#..A.A.#
.#.A......#
.#...######
.#####.....