7 6
####..
#..###
#.AA.#
#aaa.#
#.@A.#
#...##
#####.