7 6
######
#....#
#.#@.#
#.A1.#
#.a1.#
#....#
######