12 11
.....####..
.#.###..#..
.#.#....#..
.#.#..#.#..
.#.#A.#a#..
.#.#..#.#.#
.#.#A.#a#.#
...#..#.#.#
####A.#a#.#
#.@.....#.#
#...#..##.#
########...