6 19
#####...####.......
#...#####.a#.......
#.......A..########
###..####.aA....@.#
..#..#..#..####...#
..####..####..#####