8 11
.#######...
##.....##..
#..A.A..#..
#.A.A.A.#..
##.###.####
.#@..aaaaa#
.##.....###
..#######..