13 13
..#####......
..#...#......
..#.#.#######
..#..1..#...#
..##.##...#.#
..#.....#1..#
###.#.#.#.###
#..1#A+...#..
#.#...##.##..
#...#..1..#..
#######.#.#..
......#...#..
......#####..