10 13
#############
#a#.@#..#...#
#a#AA...#.A.#
#a#..#.A#...#
#a#.A#..#.A##
#a#..#.A#..#.
#a#.A#..#.A#.
#aa..#.A...#.
#aa..#..#..#.
############.