9 8
....####
#####..#
#...A..#
#..a#..#
##.##.##
#......#
#.@#...#
#..#####
####....