9 10
....#####.
...##...##
..##.a#..#
.##...@..#
##....#..#
#..A.#####
#.1.##....
#..##.....
####......