9 9
.....####
...###..#
.###.aa.#
.#.AA#..#
##.#.#@##
#..1....#
#...#...#
######..#
.....####