9 7
#####..
#...###
#.a...#
##.A..#
####A##
#..A.##
#.@...#
###a.a#
..#####