9 9
....####.
.####..#.
##.A...#.
#..#.#A#.
#a@a...##
##.#.#..#
.#......#
.#..#####
.####....