9 11
......####.
#######..#.
#........#.
#..A.#a#.#.
#.AA##.#.##
###.a.@...#
..###..#..#
....##a..##
.....#####.