8 9
.#####...
##...###.
#.a.a.a#.
#.#.##.##
#....AA@#
###.#.A.#
..#...###
..#####..