9 8
####....
#..####.
#.....#.
#.....#.
###.###.
#.AA..##
#.a.a@.#
####...#
...#####