8 8
.#####..
.#...#..
##A#.###
#...A@.#
#.#..#.#
#.#a.a.#
#...####
#####...