7 8
..####..
###..###
#...1A.#
#.#..#@#
#.#.1a.#
#...####
#####...