9 7
..####.
.##..#.
##...##
#..1A.#
#.#.#@#
#..1a.#
###..##
..#..#.
..####.