9 10
....#####.
...##...##
..##.a#..#
.##...@..#
##..1.#..#
#..A.#####
#.1.##....
#..##.....
####......