9 8
.####...
.#..####
.#.....#
.#.#a..#
##1##A##
#......#
#.#.@..#
#....###
######..