9 7
#####..
#...###
#.....#
##....#
####A##
#..A.##
#.@...#
###a.a#
..#####