9 8
.#####..
.#...##.
##a#A.##
#.A....#
#a.a#A.#
###.@.##
..#.#.#.
..#...#.
..#####.