9 8
####....
#..####.
#.....#.
#.....#.
###.###.
#.AAA.##
#.aaa@.#
####...#
...#####