9 9
....####.
.####..#.
##.A...#.
#..#.#A#.
#a@aa..##
##.#.#..#
.#...A..#
.#..#####
.####....