9 11
......####.
#######..#.
#........#.
#..A.#a#.#.
#..A##.#.##
###...@...#
..###..#..#
....##a..##
.....#####.