7 9
.#######.
.#..#..##
##.11Aa.#
#...#...#
#...@.###
#..####..
####.....