8 7
..####.
.##..#.
##.a.##
#@AAA.#
#a.a#.#
#.#...#
#...###
#####..