8 8
..#####.
###...#.
#.A.#.##
#.#..a.#
#....#.#
##A#a..#
.#@..###
.#####..