8 9
.#####...
##...###.
#.a.a..#.
#.#.##.##
#....AA@#
###.#...#
..#...###
..#####..