9 8
....####
#####..#
#...1..#
#.1a#..#
##.##.##
#.A....#
#.@#...#
#..#####
####....