9 8
########
#...#..#
#......#
##.#a..#
#....###
#.#.a.#.
#.AA#.#.
###..@#.
..#####.