9 8
########
#...#..#
#......#
##.#a.a#
#....###
#.#.1.#.
#.AA#.#.
###..@#.
..#####.