9 8
..#####.
###...#.
#.....#.
#..#a###
##@AAA.#
.#a#a#.#
.#.....#
.#..####
.####...