8 8
...####.
####..#.
#.A...#.
#..a#.##
##.#a..#
#.@..A.#
#...####
#####...