8 8
.#####..
.#...#..
##A#.###
#..aA@.#
#.#..#.#
#.#aaA.#
#...####
#####...